REB = "setup/countries/rebels.txt"
PIR = "setup/countries/pirates.txt"
BAR = "setup/countries/barbarians.txt"
MER = "setup/countries/mercenaries.txt"

# West Europe

FRA = "setup/countries/w_europe/france.txt"
GBR = "setup/countries/w_europe/great_britain.txt"
SPA = "setup/countries/w_europe/spain.txt"
NED = "setup/countries/w_europe/netherlands.txt"
POR = "setup/countries/w_europe/portugal.txt"
LUX = "setup/countries/w_europe/luxemburg.txt"

# Central Europe

AUS = "setup/countries/c_europe/austria.txt"
ANH = "setup/countries/c_europe/anhalt.txt"
BAD = "setup/countries/c_europe/baden.txt"
BAV = "setup/countries/c_europe/bavaria.txt"
BRG = "setup/countries/c_europe/braunschweig.txt"
BRE = "setup/countries/c_europe/bremen.txt"
HAM = "setup/countries/c_europe/hamburg.txt"
HAN = "setup/countries/c_europe/hannover.txt"
HSD = "setup/countries/c_europe/hesse-darmstadt.txt"
HSK = "setup/countries/c_europe/hesse-kassel.txt"
MKS = "setup/countries/c_europe/mecklenburg-schwerin.txt"
MKZ = "setup/countries/c_europe/mecklenburg-strelitz.txt"
NAS = "setup/countries/c_europe/nassau.txt"
OLD = "setup/countries/c_europe/oldenburg.txt"
PRU = "setup/countries/c_europe/prussia.txt"
SXC = "setup/countries/c_europe/saxe-coburg.txt"
SXM = "setup/countries/c_europe/saxe-meinegen.txt"
SAX = "setup/countries/c_europe/saxony.txt"
WDK = "setup/countries/c_europe/waldeck.txt"
WUR = "setup/countries/c_europe/wurttemberg.txt"
FRK = "setup/countries/c_europe/frankfurt.txt"
SWM = "setup/countries/c_europe/saxe-weimar.txt"
SRS = "setup/countries/c_europe/schwarzburg-rudolstadt.txt"
LBG = "setup/countries/c_europe/lauenburg.txt"
HOL = "setup/countries/c_europe/holstein.txt"
SWI = "setup/countries/c_europe/switzerland.txt"
LIE = "setup/countries/c_europe/liechtenstein.txt" 
HZS = "setup/countries/c_europe/hohenzollern-sigmaringen.txt" 

# Italy

SAR = "setup/countries/italy/sardinia.txt"
PRM = "setup/countries/italy/parma.txt"
MOD = "setup/countries/italy/modena.txt"
LUC = "setup/countries/italy/lucca.txt"
TUS = "setup/countries/italy/tuscany.txt"
PAP = "setup/countries/italy/papal_states.txt"
SSL = "setup/countries/italy/two_sicilies.txt"
MSS = "setup/countries/italy/massa.txt"

# Scandinavia
SHL = "setup/countries/scandinavia/schleswig.txt"
DEN = "setup/countries/scandinavia/denmark.txt"
SWE = "setup/countries/scandinavia/sweden.txt"
NOR = "setup/countries/scandinavia/norway.txt"
FIN = "setup/countries/scandinavia/finland.txt"

# East Europe

RUS = "setup/countries/e_europe/russia.txt"
POL = "setup/countries/e_europe/poland.txt"
KRA = "setup/countries/e_europe/krakow.txt"
MOL = "setup/countries/e_europe/moldavia.txt"
WAL = "setup/countries/e_europe/wallachia.txt"
SRB = "setup/countries/e_europe/serbia.txt"
ION = "setup/countries/e_europe/ionian_isles.txt"
MNR = "setup/countries/e_europe/montenegro.txt"
ATH = "setup/countries/e_europe/athos.txt"

# North America

USA = "setup/countries/n_america/usa.txt"
MEX = "setup/countries/n_america/mexico.txt"
CAN = "setup/countries/n_america/canada.txt"
CMC = "setup/countries/n_america/comanche.txt"
LKU = "setup/countries/n_america/liksiyu.txt"
YAK = "setup/countries/n_america/yakama.txt"
NSQ = "setup/countries/n_america/nisqually.txt"
MCK = "setup/countries/n_america/muckleshoot.txt"
PUY = "setup/countries/n_america/puyallup.txt"
HAI = "setup/countries/n_america/haida.txt"

# South America

VNZ = "setup/countries/s_america/venezuela.txt"
NGR = "setup/countries/s_america/new_granada.txt"
QTO = "setup/countries/s_america/quito.txt"
PR1 = "setup/countries/s_america/peru.txt"
CHL = "setup/countries/s_america/chile.txt"
AR1 = "setup/countries/s_america/argentina.txt"
BRZ = "setup/countries/s_america/brazil.txt"

# East Asia

CHI = "setup/countries/e_asia/china.txt"
KOR = "setup/countries/e_asia/korea.txt"
TIB = "setup/countries/e_asia/tibet.txt"
BHU = "setup/countries/e_asia/bhutan.txt"

# Middle East

TUR = "setup/countries/m_east/turkey.txt"
DRY = "setup/countries/m_east/diryah.txt"
MNS = "setup/countries/m_east/manisa.txt"
CIL = "setup/countries/m_east/cilicia.txt"
ABU = "setup/countries/m_east/abu_dhabi.txt"
DUB = "setup/countries/m_east/dubai.txt"
SHJ = "setup/countries/m_east/sharjah.txt"
LHJ = "setup/countries/m_east/lahej.txt"
WHD = "setup/countries/m_east/wahidi.txt"
QSM = "setup/countries/m_east/qasimi.txt"
OMA = "setup/countries/m_east/oman.txt"
MSC = "setup/countries/m_east/muscat.txt"
KWT = "setup/countries/m_east/kuwait.txt"

# Caucasus
CIR = "setup/countries/caucasus/circassia.txt"
DAG = "setup/countries/caucasus/dagestan.txt"

# North Africa
ALG = "setup/countries/n_africa/algiers.txt"
EGY = "setup/countries/n_africa/egypt.txt"
MOR = "setup/countries/n_africa/morocco.txt"
TRI = "setup/countries/n_africa/tripoli.txt"
TUN = "setup/countries/n_africa/tunis.txt"

# East Africa
MDB = "setup/countries/e_africa/medri bahri.txt"
GDR = "setup/countries/e_africa/gondar.txt"
TGR = "setup/countries/e_africa/tigray.txt"
ASA = "setup/countries/e_africa/aussa.txt"
GJJ = "setup/countries/e_africa/gojjam.txt"
SWA = "setup/countries/e_africa/shewa.txt"
WLO = "setup/countries/e_africa/wollo.txt"
HRR = "setup/countries/e_africa/harar.txt"
MLK = "setup/countries/e_africa/mamluks.txt"
SNR = "setup/countries/e_africa/sennar.txt"
MWA = "setup/countries/e_africa/massawa.txt"
OGD = "setup/countries/e_africa/ogaden.txt"
KFA = "setup/countries/e_africa/kaffa.txt"
LEN = "setup/countries/e_africa/limmu-ennarea.txt"
HOR = "setup/countries/e_africa/houara.txt"
JMA = "setup/countries/e_africa/jimma.txt"
WEA = "setup/countries/e_africa/welega.txt"
JJO = "setup/countries/e_africa/janjero.txt"
DWR = "setup/countries/e_africa/dawro.txt"
BOE = "setup/countries/e_africa/borena.txt"
SDM = "setup/countries/e_africa/sidama.txt"
KBT = "setup/countries/e_africa/kembata.txt"
WLA = "setup/countries/e_africa/wolayita.txt"
GFA = "setup/countries/e_africa/gofa.txt"
WGL = "setup/countries/e_africa/warsangli.txt"
ZEI = "setup/countries/e_africa/zeila.txt"
SLL = "setup/countries/e_africa/shilluk.txt"
MEE = "setup/countries/e_africa/majeerteen.txt"

# Malay Archipelago
LAF = "setup/countries/m_archipelago/lanfang.txt"
FOS = "setup/countries/m_archipelago/fosjoen.txt"
PNK = "setup/countries/m_archipelago/pontianak.txt"
BJM = "setup/countries/m_archipelago/banjarmasin.txt"
MGO = "setup/countries/m_archipelago/maguindanao.txt"
MNA = "setup/countries/m_archipelago/maranao.txt"
SLU = "setup/countries/m_archipelago/sulu.txt"
BRU = "setup/countries/m_archipelago/brunei.txt"
KTI = "setup/countries/m_archipelago/kutai.txt"
BGN = "setup/countries/m_archipelago/bulungan.txt"
DEI = "setup/countries/m_archipelago/dutch east indies.txt"
LWU = "setup/countries/m_archipelago/luwu.txt"
WAJ = "setup/countries/m_archipelago/wajo.txt"
BNE = "setup/countries/m_archipelago/bone.txt"
PLB = "setup/countries/m_archipelago/palembang.txt"
BCN = "setup/countries/m_archipelago/bacan.txt"
MDR = "setup/countries/m_archipelago/mandar.txt"
ACH = "setup/countries/m_archipelago/aceh.txt"
KWE = "setup/countries/m_archipelago/konawe.txt"
PLU = "setup/countries/m_archipelago/palu.txt"
SGI = "setup/countries/m_archipelago/sigi.txt" 
TLI = "setup/countries/m_archipelago/toli toli.txt"
DGL = "setup/countries/m_archipelago/donggala.txt"
BLI = "setup/countries/m_archipelago/bali.txt" #Represents the 9 kingdoms of Bali
BTN = "setup/countries/m_archipelago/buton.txt"
JBI = "setup/countries/m_archipelago/jambi.txt"
SIK = "setup/countries/m_archipelago/siak.txt"
PGR = "setup/countries/m_archipelago/pagaruyung.txt" 
JHR = "setup/countries/m_archipelago/johor.txt" 
SGR = "setup/countries/m_archipelago/selangor.txt"
TGN = "setup/countries/m_archipelago/terengganu.txt"
PRK = "setup/countries/m_archipelago/perak.txt"
PRI = "setup/countries/m_archipelago/padri.txt"
MLU = "setup/countries/m_archipelago/maluka.txt" 
BJR = "setup/countries/m_archipelago/banjar.txt"
BUS = "setup/countries/m_archipelago/barus.txt"
ASH = "setup/countries/m_archipelago/asahan.txt"
LGK = "setup/countries/m_archipelago/langkat.txt"
SGL = "setup/countries/m_archipelago/sungai lemau.txt"
PSR = "setup/countries/m_archipelago/paser.txt"
KDH = "setup/countries/m_archipelago/kedah.txt"
STL = "setup/countries/m_archipelago/setul.txt"
NGS = "setup/countries/m_archipelago/negeri sembilan.txt"
GNT = "setup/countries/m_archipelago/ganung tabor.txt"
SBL = "setup/countries/m_archipelago/sambaliung.txt"
SAM = "setup/countries/m_archipelago/sambas.txt"
KOT = "setup/countries/m_archipelago/kotawaringin.txt"
BTR = "setup/countries/m_archipelago/buntar laut.txt"

# Australasia
NSW = "setup/countries/australasia/new_south_wales.txt"
NGA = "setup/countries/n_zealand/ngapuhi.txt"
NGW = "setup/countries/n_zealand/ngati whatua.txt" 
TNK = "setup/countries/n_zealand/taranaki.txt"
NGT = "setup/countries/n_zealand/ngati tamatera.txt"
NTR = "setup/countries/n_zealand/ngati te rangi.txt"
NMU = "setup/countries/n_zealand/ngati mahuta.txt"
NRU = "setup/countries/n_zealand/ngati ruanui.txt"
NWT = "setup/countries/n_zealand/ngati whanaunga.txt"
NMP = "setup/countries/n_zealand/ngati maniapoto.txt"
NTW = "setup/countries/n_zealand/ngati tuwharetoa.txt"

# Indo China 
SIA = "setup/countries/indo_china/siam.txt"
CPK = "setup/countries/indo_china/champasak.txt"
CBI = "setup/countries/indo_china/cambodia.txt"
VIN = "setup/countries/indo_china/vientiane.txt"
CMI = "setup/countries/indo_china/chiang mai.txt"
LPR = "setup/countries/indo_china/luang prabang.txt"
BUR = "setup/countries/indo_china/burma.txt"
VIE = "setup/countries/indo_china/vietnam.txt"
CPA = "setup/countries/indo_china/champa.txt"
KTG = "setup/countries/indo_china/kentung.txt"
CHH = "setup/countries/indo_china/chiang hung.txt"
MLM = "setup/countries/indo_china/monglem.txt"
TNI = "setup/countries/indo_china/theinni.txt"

# Japan 
SHZ = "setup/countries/japan/shimazu.txt"
NTO = "setup/countries/japan/naito.txt"
HKW = "setup/countries/japan/hosokawa.txt"
YCH = "setup/countries/japan/yamauchi.txt"
HCH = "setup/countries/japan/hachisuka.txt"
TGU = "setup/countries/japan/tsugaru.txt"
NMB = "setup/countries/japan/nambu.txt"
MAE = "setup/countries/japan/matsunae.txt"
TKG = "setup/countries/japan/tokugawa.txt"
SKE = "setup/countries/japan/satake.txt"
DTE = "setup/countries/japan/date.txt"
MED = "setup/countries/japan/maeda.txt"
HDA = "setup/countries/japan/honda.txt"
CSU = "setup/countries/japan/choshu.txt"
ASN = "setup/countries/japan/asano.txt"
KTO = "setup/countries/japan/kato.txt"
ECH = "setup/countries/japan/echizen.txt"
SGA = "setup/countries/japan/saga.txt"
JZI = "setup/countries/japan/jozai.txt"
OBM = "setup/countries/japan/obama.txt"
TKU = "setup/countries/japan/takamatsu.txt"
SBT = "setup/countries/japan/shibata.txt"
AZU = "setup/countries/japan/aizu.txt"
MYZ = "setup/countries/japan/miyazu.txt"
IWM = "setup/countries/japan/iwami.txt"
OKA = "setup/countries/japan/okayama.txt"
RYU = "setup/countries/japan/ryukyu.txt"
HJI = "setup/countries/japan/himeji.txt"
FUK = "setup/countries/japan/fukuoka.txt"
TSU = "setup/countries/japan/tsu.txt"
BGO = "setup/countries/japan/bungo.txt"
SNI = "setup/countries/japan/shonai.txt"

#India

EIC = "setup/countries/india/east_india_company.txt"
MYS = "setup/countries/india/mysore.txt"
COO = "setup/countries/india/coorg.txt"
TRV = "setup/countries/india/travancore.txt"
HYD = "setup/countries/india/hyderabad.txt"
MRT = "setup/countries/india/maratha.txt"
INR = "setup/countries/india/indore.txt"
GUJ = "setup/countries/india/gujarat.txt"
GWA = "setup/countries/india/gwalior.txt"
TJR = "setup/countries/india/thanjavur.txt"
NAG = "setup/countries/india/nagpur.txt"
BHO = "setup/countries/india/bhopal.txt"
ORC = "setup/countries/india/orchha.txt"
REW = "setup/countries/india/rewa.txt"
BRD = "setup/countries/india/baroda.txt"
KTC = "setup/countries/india/kutch.txt"
RTL = "setup/countries/india/ratlam.txt"
JHN = "setup/countries/india/jhansi.txt"
VID = "setup/countries/india/vidarbha.txt"
KHA = "setup/countries/india/khandela.txt"
DHA = "setup/countries/india/dhar.txt"
CHP = "setup/countries/india/chhatarpur.txt"
JMK = "setup/countries/india/jamkhandi.txt"
RMD = "setup/countries/india/rhamdurg.txt"
KOL = "setup/countries/india/kolhapur.txt"
KTW = "setup/countries/india/kathiawar.txt"
DHN = "setup/countries/india/dhanwar.txt"
RMH = "setup/countries/india/ramgarh.txt"
BNR = "setup/countries/india/benares.txt"
BIH = "setup/countries/india/bihar.txt"
KHR = "setup/countries/india/khorda.txt"
PAT = "setup/countries/india/patna.txt"
AWA = "setup/countries/india/awadh.txt"
BIK = "setup/countries/india/bikaner.txt"
JAI = "setup/countries/india/jaisalmer.txt"
SND = "setup/countries/india/jaisalmer.txt"
MAR = "setup/countries/india/marwar.txt"
KHL = "setup/countries/india/khalistan.txt"
BWP = "setup/countries/india/bahawalpur.txt"
LDK = "setup/countries/india/ladakh.txt"
LSB = "setup/countries/india/las_bela.txt"
KRN = "setup/countries/india/kharan.txt"
ASS = "setup/countries/india/assam.txt"
MNP = "setup/countries/india/manipur.txt"
KRI = "setup/countries/india/kachari.txt"
JNT = "setup/countries/india/jaintia.txt"
KND = "setup/countries/india/kandy.txt"

# Central asia
PR2 = "setup/countries/c_asia/persia.txt"
AFG = "setup/countries/c_asia/afghanistan.txt"
KAL = "setup/countries/c_asia/kalat.txt"
KHV = "setup/countries/c_asia/khiva.txt"
BUK = "setup/countries/c_asia/bukhara.txt"
KOK = "setup/countries/c_asia/kokand.txt"
